00000000000000000000
00000000000000000000
00000000000000000000
00000000000000000000
00000000900000000000
00000011111000000000
00000000000000000000
00000200S00200000000
00000111111111000000
00000000000000000000
00000000000000000000
00000000000000000000
