00000000000000000000
00033000000000000000
00330000000000000000
03300000000000000000
33000000000000000000
30000000000090200000
00000000002300200000
00000000002300200000
000000S0002300000000
00001111111111110000
00000000000000000000
00000000000000000000
