00000000000000000000
00000000000000110000
00000000000000000000
00000000000000000000
00000000900000000000
00000011111000000000
00000000000000000000
00000200000200000000
000S0111111111000000
00000000000000000000
00000000000000000000
00000000000000000000
